1000000000
0000000000
0000000000
0000000000
0000000000
0000000000
0000000000
0000000000
0000000000
0000000000

0011001001
1001001011
1000110100
0011010110
1001010010
1100100101
0101001101
1001001001
1001001010
0011010011
